=================================================================
c:\>netstat /?

Displays protocol statistics and current TCP/IP network connections.

NETSTAT [-a] [-b] [-e] [-f] [-i] [-n] [-o] [-p proto] [-r] [-s] [-t] [-x] [-y] [interval]

  -a            Displays all connections and listening ports.
  -b            Displays the executable involved in creating each connection or
                listening port. In some cases well-known executables host
                multiple independent components, and in these cases the
                sequence of components involved in creating the connection
                or listening port is displayed. In this case the executable
                name is in [] at the bottom, on top is the component it called,
                and so forth until TCP/IP was reached. Note that this option
                can be time-consuming and will fail unless you have sufficient
                permissions.
Note: -b require elevated cmd / powershell prompt.
  -e            Displays Ethernet statistics. This may be combined with the -s
                option.
  -f            Displays Fully Qualified Domain Names (FQDN) for foreign
                addresses.
  -i            Displays the time spent by a TCP connection in its current state.
  -n            Displays addresses and port numbers in numerical form.
  -o            Displays the owning process ID associated with each connection.
  -p proto      Shows connections for the protocol specified by proto; proto
                may be any of: TCP, UDP, TCPv6, or UDPv6.  If used with the -s
                option to display per-protocol statistics, proto may be any of:
                IP, IPv6, ICMP, ICMPv6, TCP, TCPv6, UDP, or UDPv6.
  -q            Displays all connections, listening ports, and bound
                nonlistening TCP ports. Bound nonlistening ports may or may not
                be associated with an active connection.
  -r            Displays the routing table.
  -s            Displays per-protocol statistics.  By default, statistics are
                shown for IP, IPv6, ICMP, ICMPv6, TCP, TCPv6, UDP, and UDPv6;
                the -p option may be used to specify a subset of the default.
  -t            Displays the current connection offload state.
  -x            Displays NetworkDirect connections, listeners, and shared
                endpoints.
  -y            Displays the TCP connection template for all connections.
                Cannot be combined with the other options.
  interval      Redisplays selected statistics, pausing interval seconds
                between each display.  Press CTRL+C to stop redisplaying
                statistics.  If omitted, netstat will print the current
                configuration information once.


c:\>
====================================================================

Example 1: 
-a : Display all connections and listending ports
-n : Displays addresses and port numbers in numerical form
-o : Displays the owning process ID assoicated with each connection

c:\>netstat -ano

Active Connections

  Proto  Local Address          Foreign Address        State           PID

--------------

======================================================================================

C:\>certutil /?

Verbs:
  -dump             -- Dump configuration information or file
  -dumpPFX          -- Dump PFX structure
  -asn              -- Parse ASN.1 file

  -decodehex        -- Decode hexadecimal-encoded file
  -decode           -- Decode Base64-encoded file
  -encode           -- Encode file to Base64

  -deny             -- Deny pending request
  -resubmit         -- Resubmit pending request
  -setattributes    -- Set attributes for pending request
  -setextension     -- Set extension for pending request
  -revoke           -- Revoke Certificate
  -isvalid          -- Display current certificate disposition

  -getconfig        -- Get default configuration string
  -ping             -- Ping Active Directory Certificate Services Request interface
  -pingadmin        -- Ping Active Directory Certificate Services Admin interface
  -CAInfo           -- Display CA Information
  -ca.cert          -- Retrieve the CA's certificate
  -ca.chain         -- Retrieve the CA's certificate chain
  -GetCRL           -- Get CRL
  -CRL              -- Publish new CRLs [or delta CRLs only]
  -shutdown         -- Shutdown Active Directory Certificate Services

  -installCert      -- Install Certification Authority certificate
  -renewCert        -- Renew Certification Authority certificate

  -schema           -- Dump Certificate Schema
  -view             -- Dump Certificate View
  -db               -- Dump Raw Database
  -deleterow        -- Delete server database row

  -backup           -- Backup Active Directory Certificate Services
  -backupDB         -- Backup Active Directory Certificate Services database
  -backupKey        -- Backup Active Directory Certificate Services certificate and private key
  -restore          -- Restore Active Directory Certificate Services
  -restoreDB        -- Restore Active Directory Certificate Services database
  -restoreKey       -- Restore Active Directory Certificate Services certificate and private key
  -importPFX        -- Import certificate and private key
  -dynamicfilelist  -- Display dynamic file List
  -databaselocations -- Display database locations
  -hashfile         -- Generate and display cryptographic hash over a file

  -store            -- Dump certificate store
  -enumstore        -- Enumerate certificate stores
  -addstore         -- Add certificate to store
  -delstore         -- Delete certificate from store
  -verifystore      -- Verify certificate in store
  -repairstore      -- Repair key association or update certificate properties or key security descriptor
  -viewstore        -- Dump certificate store
  -viewdelstore     -- Delete certificate from store
  -UI               -- invoke CryptUI
  -attest           -- Verify Key Attestation Request

  -dsPublish        -- Publish certificate or CRL to Active Directory

  -ADTemplate       -- Display AD templates
  -Template         -- Display Enrollment Policy templates
  -TemplateCAs      -- Display CAs for template
  -CATemplates      -- Display templates for CA
  -SetCASites       -- Manage Site Names for CAs
  -enrollmentServerURL -- Display, add or delete enrollment server URLs associated with a CA
  -ADCA             -- Display AD CAs
  -CA               -- Display Enrollment Policy CAs
  -Policy           -- Display Enrollment Policy
  -PolicyCache      -- Display or delete Enrollment Policy Cache entries
  -CredStore        -- Display, add or delete Credential Store entries
  -InstallDefaultTemplates -- Install default certificate templates
  -URLCache         -- Display or delete URL cache entries
  -pulse            -- Pulse autoenrollment event or NGC task
  -MachineInfo      -- Display Active Directory machine object information
  -DCInfo           -- Display domain controller information
  -EntInfo          -- Display enterprise information
  -TCAInfo          -- Display CA information
  -SCInfo           -- Display smart card information

  -SCRoots          -- Manage smart card root certificates

  -DeleteHelloContainer -- Delete Hello Logon container.
     ** Users need to sign out after using this option for it to complete. **
  -verifykeys       -- Verify public/private key set
  -verify           -- Verify certificate, CRL or chain
  -verifyCTL        -- Verify AuthRoot or Disallowed Certificates CTL
  -syncWithWU       -- Sync with Windows Update
  -generateSSTFromWU -- Generate SST from Windows Update
  -generatePinRulesCTL -- Generate Pin Rules CTL
  -downloadOcsp     -- Download OCSP Responses and Write to Directory
  -generateHpkpHeader -- Generate HPKP header using certificates in specified file or directory
  -flushCache       -- Flush specified caches in selected process, such as, lsass.exe
  -addEccCurve      -- Add ECC Curve
  -deleteEccCurve   -- Delete ECC Curve
  -displayEccCurve  -- Display ECC Curve
  -sign             -- Re-sign CRL or certificate

  -vroot            -- Create/delete web virtual roots and file shares
  -vocsproot        -- Create/delete web virtual roots for OCSP web proxy
  -addEnrollmentServer -- Add an Enrollment Server application
  -deleteEnrollmentServer -- Delete an Enrollment Server application
  -addPolicyServer  -- Add a Policy Server application
  -deletePolicyServer -- Delete a Policy Server application
  -oid              -- Display ObjectId or set display name
  -error            -- Display error code message text
  -getreg           -- Display registry value
  -setreg           -- Set registry value
  -delreg           -- Delete registry value

  -ImportKMS        -- Import user keys and certificates into server database for key archival
  -ImportCert       -- Import a certificate file into the database
  -GetKey           -- Retrieve archived private key recovery blob, generate a recovery script,
      or recover archived keys
  -RecoverKey       -- Recover archived private key
  -MergePFX         -- Merge PFX files
  -ConvertEPF       -- Convert PFX files to EPF file

  -add-chain        -- (-AddChain) Add certificate chain
  -add-pre-chain    -- (-AddPrechain) Add pre-certificate chain
  -get-sth          -- (-GetSTH) Get signed tree head
  -get-sth-consistency -- (-GetSTHConsistency) Get signed tree head changes
  -get-proof-by-hash -- (-GetProofByHash) Get proof by hash
  -get-entries      -- (-GetEntries) Get entries
  -get-roots        -- (-GetRoots) Get roots
  -get-entry-and-proof -- (-GetEntryAndProof) Get entry and proof
  -VerifyCT         -- Verify certificate SCT
  -?                -- Display this usage message


CertUtil -?              -- Display a verb list (command list)
CertUtil -dump -?        -- Display help text for the "dump" verb
CertUtil -v -?           -- Display all help text for all verbs

CertUtil: -? command completed successfully.

------------------------------------------------------
Example download a file on Windows system remotely 

C:\>certutil -urlcache -f http://<IP>:<PORT>/myfile myfile
